2 17 25
#########################
#p          2      d#  *#
# # # # #* # # # # #*# ##
# d                     #
# #*# # # #b#1# # # # #*#
#   *      **      *  **#
# # #*#   #*#*#*#*# # # #
#     *   *  *x* *      #
# #*# # ## # #  #*# #*# #
#                     6 #
# # # # # # *# # # # #* #
#  ** *   *             #
# # # #  # #*# # # #  #*#
#  **     1   * *       #
# # # # # # *# # # # #* #
# k ** *   *    5       #
#########################