3 17 25
#########################
#p   ** **    *   2   k #
# # # #*# # # # # # # # #
#*     ** * *  *   *    #
# # # # # #*# # # # # # #
#*   *s*    *** * x *   #
# # # # # # # # # # #*# #
#    * b   *   b    *  3#
# #*# # #*#*#*#*# # #*# #
#        *   *2*    *   #
#*# # # # # # # # # # #*#
#    *  s  * f* *   *  3#
# #*# # #*#*#*#*# # #*# #
# *    * **    ** ***  *#
# # # #*# # # # # # # # #
#   f  ** * *  *   *  d #
#########################