4 17 25
#########################
#p    * **    *   3   4 #
# # # #*# # # # # # # # #
#  ** * *  *  * ** 3 *  #
# # #*# # # # # # #*# # #
#*   * *    *b* *   **  #
# # # # # # # # # # #*# #
#    *   *    *    **  3#
# #*#*#*#*# # #1# # #*# #
#   k* 4 *2*    *   *   #
#*# # # # # # # #*# # #*#
#*   * *    *b* *   **  #
# # # # # # # # # # #*# #
#x*    * **  ***    1   #
# #*#*#*#*# # #1# # #*# #
#    * 4 *2*    *   *d  #
#########################