5 17 25
#########################
#p * *3       *  ** * k*#
# # # # #*# # # # # #*# #
#   b* * *** **  1  **  #
# #*# #4# #b#1# # # # #*#
# bf *     **      *  **#
# # #*# # #*#*#*#*# # # #
#   *  *   * *x* *   4  #
# # # # #*# # # #*# #*# #
#*   * *    *b* *   **  #
# # # # # # # # # # #*# #
#   *  *6    ***  **    #
# # # # # # #*# # # # #*#
#   *  *2    ***  **    #
# # # # # # #*# # # # #*#
#  ** *5  *    2      d #
#########################